"filename", "language", "Java", "SQL", "comment", "blank", "total"
"/home/ndong/Documents/Java-Programming/spring/course-web/src/main/java/com/ndong/courseweb/CourseWebApplication.java", "Java", 19, 0, 1, 6, 26
"/home/ndong/Documents/Java-Programming/spring/course-web/src/main/java/com/ndong/courseweb/ServletInitializer.java", "Java", 9, 0, 0, 7, 16
"/home/ndong/Documents/Java-Programming/spring/course-web/src/main/java/com/ndong/courseweb/constant/CourseStatusConstant.java", "Java", 7, 0, 0, 3, 10
"/home/ndong/Documents/Java-Programming/spring/course-web/src/main/java/com/ndong/courseweb/constant/DefaultValueConstant.java", "Java", 6, 0, 0, 2, 8
"/home/ndong/Documents/Java-Programming/spring/course-web/src/main/java/com/ndong/courseweb/constant/FilterCodeConstant.java", "Java", 7, 0, 0, 2, 9
"/home/ndong/Documents/Java-Programming/spring/course-web/src/main/java/com/ndong/courseweb/constant/SystemConstant.java", "Java", 29, 0, 0, 4, 33
"/home/ndong/Documents/Java-Programming/spring/course-web/src/main/java/com/ndong/courseweb/constant/UserConstant.java", "Java", 8, 0, 0, 2, 10
"/home/ndong/Documents/Java-Programming/spring/course-web/src/main/java/com/ndong/courseweb/controller/admin/ManagerPageController.java", "Java", 33, 0, 0, 8, 41
"/home/ndong/Documents/Java-Programming/spring/course-web/src/main/java/com/ndong/courseweb/controller/admin/api/CategoryAPI.java", "Java", 35, 0, 0, 9, 44
"/home/ndong/Documents/Java-Programming/spring/course-web/src/main/java/com/ndong/courseweb/controller/admin/api/MediaTypeAPI.java", "Java", 39, 0, 0, 9, 48
"/home/ndong/Documents/Java-Programming/spring/course-web/src/main/java/com/ndong/courseweb/controller/web/CourseController.java", "Java", 235, 0, 0, 31, 266
"/home/ndong/Documents/Java-Programming/spring/course-web/src/main/java/com/ndong/courseweb/controller/web/HomeController.java", "Java", 71, 0, 0, 15, 86
"/home/ndong/Documents/Java-Programming/spring/course-web/src/main/java/com/ndong/courseweb/controller/web/UserController.java", "Java", 76, 0, 0, 15, 91
"/home/ndong/Documents/Java-Programming/spring/course-web/src/main/java/com/ndong/courseweb/controller/web/api/CourseAPI.java", "Java", 31, 0, 0, 10, 41
"/home/ndong/Documents/Java-Programming/spring/course-web/src/main/java/com/ndong/courseweb/controller/web/api/MediaAPI.java", "Java", 58, 0, 0, 12, 70
"/home/ndong/Documents/Java-Programming/spring/course-web/src/main/java/com/ndong/courseweb/controller/web/api/UserAPI.java", "Java", 26, 0, 0, 7, 33
"/home/ndong/Documents/Java-Programming/spring/course-web/src/main/java/com/ndong/courseweb/database/initdb.sql", "SQL", 0, 21, 0, 4, 25
"/home/ndong/Documents/Java-Programming/spring/course-web/src/main/java/com/ndong/courseweb/database/insert_courses.sql", "SQL", 0, 1142, 0, 1, 1143
"/home/ndong/Documents/Java-Programming/spring/course-web/src/main/java/com/ndong/courseweb/database/insert_purchase_detail.sql", "SQL", 0, 21, 0, 1, 22
"/home/ndong/Documents/Java-Programming/spring/course-web/src/main/java/com/ndong/courseweb/dto/AbstractDTO.java", "Java", 53, 0, 0, 17, 70
"/home/ndong/Documents/Java-Programming/spring/course-web/src/main/java/com/ndong/courseweb/dto/CategoryDTO.java", "Java", 19, 0, 3, 8, 30
"/home/ndong/Documents/Java-Programming/spring/course-web/src/main/java/com/ndong/courseweb/dto/CourseDTO.java", "Java", 91, 0, 3, 40, 134
"/home/ndong/Documents/Java-Programming/spring/course-web/src/main/java/com/ndong/courseweb/dto/LessonDTO.java", "Java", 69, 0, 3, 30, 102
"/home/ndong/Documents/Java-Programming/spring/course-web/src/main/java/com/ndong/courseweb/dto/MediaDTO.java", "Java", 77, 0, 3, 37, 117
"/home/ndong/Documents/Java-Programming/spring/course-web/src/main/java/com/ndong/courseweb/dto/MediaTypeDTO.java", "Java", 26, 0, 3, 13, 42
"/home/ndong/Documents/Java-Programming/spring/course-web/src/main/java/com/ndong/courseweb/dto/UserDTO.java", "Java", 104, 0, 3, 32, 139
"/home/ndong/Documents/Java-Programming/spring/course-web/src/main/java/com/ndong/courseweb/dto/query_result/NbUserPerCourseIdDTO.java", "Java", 21, 0, 0, 7, 28
"/home/ndong/Documents/Java-Programming/spring/course-web/src/main/java/com/ndong/courseweb/entity/CategoryEntity.java", "Java", 38, 0, 0, 13, 51
"/home/ndong/Documents/Java-Programming/spring/course-web/src/main/java/com/ndong/courseweb/entity/CourseEntity.java", "Java", 111, 0, 0, 40, 151
"/home/ndong/Documents/Java-Programming/spring/course-web/src/main/java/com/ndong/courseweb/entity/LessonEntity.java", "Java", 80, 0, 0, 30, 110
"/home/ndong/Documents/Java-Programming/spring/course-web/src/main/java/com/ndong/courseweb/entity/MediaEntity.java", "Java", 68, 0, 1, 20, 89
"/home/ndong/Documents/Java-Programming/spring/course-web/src/main/java/com/ndong/courseweb/entity/MediaTypeEntity.java", "Java", 46, 0, 0, 16, 62
"/home/ndong/Documents/Java-Programming/spring/course-web/src/main/java/com/ndong/courseweb/entity/PurchaseDetailEntity.java", "Java", 50, 0, 0, 19, 69
"/home/ndong/Documents/Java-Programming/spring/course-web/src/main/java/com/ndong/courseweb/entity/UserEntity.java", "Java", 115, 0, 2, 42, 159
"/home/ndong/Documents/Java-Programming/spring/course-web/src/main/java/com/ndong/courseweb/entity/composite_id/LessonId.java", "Java", 40, 0, 3, 14, 57
"/home/ndong/Documents/Java-Programming/spring/course-web/src/main/java/com/ndong/courseweb/entity/composite_id/PurchaseDetailId.java", "Java", 40, 0, 4, 16, 60
"/home/ndong/Documents/Java-Programming/spring/course-web/src/main/java/com/ndong/courseweb/filter/IFilter.java", "Java", 10, 0, 0, 3, 13
"/home/ndong/Documents/Java-Programming/spring/course-web/src/main/java/com/ndong/courseweb/filter/impl/CourseFilter.java", "Java", 165, 0, 0, 15, 180
"/home/ndong/Documents/Java-Programming/spring/course-web/src/main/java/com/ndong/courseweb/interceptor/CourseInterceptor.java", "Java", 21, 0, 0, 5, 26
"/home/ndong/Documents/Java-Programming/spring/course-web/src/main/java/com/ndong/courseweb/interceptor/EditCoursePermissionIntercepter.java", "Java", 33, 0, 0, 10, 43
"/home/ndong/Documents/Java-Programming/spring/course-web/src/main/java/com/ndong/courseweb/interceptor/LoginInterceptor.java", "Java", 17, 0, 0, 3, 20
"/home/ndong/Documents/Java-Programming/spring/course-web/src/main/java/com/ndong/courseweb/interceptor/RequireLoginInterceptor.java", "Java", 20, 0, 0, 3, 23
"/home/ndong/Documents/Java-Programming/spring/course-web/src/main/java/com/ndong/courseweb/interceptor/WebInterceptor.java", "Java", 25, 0, 0, 7, 32
"/home/ndong/Documents/Java-Programming/spring/course-web/src/main/java/com/ndong/courseweb/interceptor/config/InterceptorConfig.java", "Java", 33, 0, 16, 9, 58
"/home/ndong/Documents/Java-Programming/spring/course-web/src/main/java/com/ndong/courseweb/repository/CategoryRepository.java", "Java", 6, 0, 0, 3, 9
"/home/ndong/Documents/Java-Programming/spring/course-web/src/main/java/com/ndong/courseweb/repository/CourseRepository.java", "Java", 22, 0, 0, 4, 26
"/home/ndong/Documents/Java-Programming/spring/course-web/src/main/java/com/ndong/courseweb/repository/LessonRepository.java", "Java", 13, 0, 0, 6, 19
"/home/ndong/Documents/Java-Programming/spring/course-web/src/main/java/com/ndong/courseweb/repository/MediaRepository.java", "Java", 6, 0, 0, 3, 9
"/home/ndong/Documents/Java-Programming/spring/course-web/src/main/java/com/ndong/courseweb/repository/MediaTypeRepository.java", "Java", 7, 0, 0, 3, 10
"/home/ndong/Documents/Java-Programming/spring/course-web/src/main/java/com/ndong/courseweb/repository/PurchaseDetailRepository.java", "Java", 16, 0, 0, 7, 23
"/home/ndong/Documents/Java-Programming/spring/course-web/src/main/java/com/ndong/courseweb/repository/UserRepository.java", "Java", 7, 0, 0, 3, 10
"/home/ndong/Documents/Java-Programming/spring/course-web/src/main/java/com/ndong/courseweb/service/ICategoryService.java", "Java", 9, 0, 0, 4, 13
"/home/ndong/Documents/Java-Programming/spring/course-web/src/main/java/com/ndong/courseweb/service/ICourseService.java", "Java", 26, 0, 0, 4, 30
"/home/ndong/Documents/Java-Programming/spring/course-web/src/main/java/com/ndong/courseweb/service/IMediaService.java", "Java", 19, 0, 0, 4, 23
"/home/ndong/Documents/Java-Programming/spring/course-web/src/main/java/com/ndong/courseweb/service/IMediaTypeService.java", "Java", 12, 0, 0, 5, 17
"/home/ndong/Documents/Java-Programming/spring/course-web/src/main/java/com/ndong/courseweb/service/IStorageService.java", "Java", 9, 0, 0, 4, 13
"/home/ndong/Documents/Java-Programming/spring/course-web/src/main/java/com/ndong/courseweb/service/IUserService.java", "Java", 15, 0, 0, 3, 18
"/home/ndong/Documents/Java-Programming/spring/course-web/src/main/java/com/ndong/courseweb/service/impl/CategoryService.java", "Java", 61, 0, 0, 9, 70
"/home/ndong/Documents/Java-Programming/spring/course-web/src/main/java/com/ndong/courseweb/service/impl/CourseService.java", "Java", 268, 0, 0, 36, 304
"/home/ndong/Documents/Java-Programming/spring/course-web/src/main/java/com/ndong/courseweb/service/impl/MediaService.java", "Java", 177, 0, 0, 22, 199
"/home/ndong/Documents/Java-Programming/spring/course-web/src/main/java/com/ndong/courseweb/service/impl/MediaTypeService.java", "Java", 69, 0, 0, 11, 80
"/home/ndong/Documents/Java-Programming/spring/course-web/src/main/java/com/ndong/courseweb/service/impl/StorageService.java", "Java", 47, 0, 0, 12, 59
"/home/ndong/Documents/Java-Programming/spring/course-web/src/main/java/com/ndong/courseweb/service/impl/UserService.java", "Java", 178, 0, 0, 25, 203
"/home/ndong/Documents/Java-Programming/spring/course-web/src/main/java/com/ndong/courseweb/utils/CodeFactory.java", "Java", 24, 0, 0, 8, 32
"/home/ndong/Documents/Java-Programming/spring/course-web/src/main/java/com/ndong/courseweb/utils/ConverterFactory.java", "Java", 46, 0, 0, 8, 54
"/home/ndong/Documents/Java-Programming/spring/course-web/src/main/java/com/ndong/courseweb/utils/MediaTextUtils.java", "Java", 40, 0, 0, 9, 49
"/home/ndong/Documents/Java-Programming/spring/course-web/src/main/java/com/ndong/courseweb/utils/SessionUtils.java", "Java", 45, 0, 0, 11, 56
"Total", "-", 3183, 1184, 45, 801, 5213